/ caPman mapfile generated by caPman level editor
3  1  1  1  1  1  1  1  1  1  1  1  1  1  7  7  1  1  1  1  1  1  1  1  1  1  1  1  1  4  
1  0  0  0  0  0  0  0  0  0  0  0  0  0  1  1  0  0  0  0  0  0  0  0  0  0  0  0  0  1  
1  0  0  0  0  0  0  0  0  0  0  0  0  0  1  1  0  0  0  0  0  0  0  0  0  0  0  0  0  1  
1  0  0  3  1  4  0  0  3  1  1  4  0  0  1  1  0  0  3  1  1  4  0  0  3  1  4  0  0  1  
1  0  0  6  1  5  0  0  6  1  1  5  0  0  6  5  0  0  6  1  1  5  0  0  6  1  5  0  0  1  
1  0  0  0  0  0  0  0  0  0  0  0  0  0  0  0  0  0  0  0  0  0  0  0  0  0  0  0  0  1  
1  0  0  0  0  0  0  0  0  0  0  0  0  0  0  0  0  0  0  0  0  0  0  0  0  0  0  0  0  1  
1  0  0  9  1  9  0  0  9  0  0  9  1  1  7  7  1  1  9  0  0  9  0  0  9  1  9  0  0  1  
1  0  0  0  0  0  0  0  1  0  0  0  0  0  1  1  0  0  0  0  0  1  0  0  0  0  0  0  0  1  
1  0  0  0  0  0  0  0  1  0  0  0  0  0  1  1  0  0  0  0  0  1  0  0  0  0  0  0  0  1  
7  1  1  1  1  4  0  0  7  1  1  9  0  0  6  5  0  0  9  1  1  8  0  0  3  1  1  1  1  8  
1  0  0  0  0  1  0  0  1  0  0  0  0  0  0  0  0  0  0  0  0  1  0  0  1  0  0  0  0  1  
1  0  0  0  0  1  0  0  1  0  0  0  0  0  0  0  0  0  0  0  0  1  0  0  1  0  0  0  0  1  
6  1  1  1  1  5  0  0  9  0  0  3  1  9  2  2  9  1  4  0  0  9  0  0  6  1  1  1  1  5  
0  0  0  0  0  0  0  0  0  0  0  1  0  0  0  0  0  0  1  0  0  0  0  0  0  0  0  0  0  0  
0  0  0  0  0  0  0  0  0  0  0  1  0  0  0  0  0  0  1  0  0  0  0  0  0  0  0  0  0  0  
3  1  1  1  1  4  0  0  9  0  0  1  0  0  0  0  0  0  1  0  0  9  0  0  3  1  1  1  1  4  
1  0  0  0  0  1  0  0  1  0  0  1  0  0  0  0  0  0  1  0  0  1  0  0  1  0  0  0  0  1  
1  0  0  0  0  1  0  0  1  0  0  6  1  1  1  1  1  1  5  0  0  1  0  0  1  0  0  0  0  1  
7  1  1  1  1  5  0  0  9  0  0  0  0  0  0  0  0  0  0  0  0  9  0  0  6  1  1  1  1  8  
1  0  0  0  0  0  0  0  0  0  0  0  0  0  0  0  0  0  0  0  0  0  0  0  0  0  0  0  0  1  
1  0  0  0  0  0  0  0  0  0  0  9  0  0  3  4  0  0  9  0  0  0  0  0  0  0  0  0  0  1  
1  0  0  9  1  4  0  0  9  1  1  5  0  0  6  5  0  0  6  1  1  9  0  0  3  1  9  0  0  1  
1  0  0  0  0  1  0  0  0  0  0  0  0  0  0  0  0  0  0  0  0  0  0  0  1  0  0  0  0  1  
1  0  0  0  0  1  0  0  0  0  0  0  0  0  0  0  0  0  0  0  0  0  0  0  1  0  0  0  0  1  
7  1  9  0  0  9  0  0  9  0  0  9  1  1  7  7  1  1  9  0  0  9  0  0  9  0  0  9  1  8  
1  0  0  0  0  0  0  0  1  0  0  0  0  0  1  1  0  0  0  0  0  1  0  0  0  0  0  0  0  1  
1  0  0  0  0  0  0  0  1  0  0  0  0  0  1  1  0  0  0  0  0  1  0  0  0  0  0  0  0  1  
1  0  0  9  1  1  1  1  8  1  1  9  0  0  6  5  0  0  9  1  1  8  1  1  1  1  9  0  0  1  
1  0  0  0  0  0  0  0  0  0  0  0  0  0  0  0  0  0  0  0  0  0  0  0  0  0  0  0  0  1  
1  0  0  0  0  0  0  0  0  0  0  0  0  0  0  0  0  0  0  0  0  0  0  0  0  0  0  0  0  1  
6  1  1  1  1  1  1  1  1  1  1  1  1  1  1  1  1  1  1  1  1  1  1  1  1  1  1  1  1  5  
