/ caPman mapfile generated by caPman level editor
3  1  1  1  1  1  1  1  1  1  1  1  1  1  1  1  1  1  1  1  1  1  1  1  1  1  1  1  1  4  
1  0  0  0  0  0  0  0  0  0  0  0  0  0  0  0  0  0  0  0  0  0  0  0  0  0  0  0  0  1  
1  0  0  0  0  0  0  0  0  0  0  0  0  0  0  0  0  0  0  0  0  0  0  0  0  0  0  0  0  1  
1  0  0  3  1  1  1  1  1  4  0  0  9  1  1  1  1  9  0  0  3  1  1  1  1  1  4  0  0  1  
1  0  0  1  0  0  0  0  0  1  0  0  0  0  0  0  0  0  0  0  1  0  0  0  0  0  1  0  0  1  
1  0  0  6  1  1  1  1  1  5  0  0  0  0  0  0  0  0  0  0  6  1  1  1  1  1  5  0  0  1  
1  0  0  0  0  0  0  0  0  0  0  0  3  1  1  1  1  4  0  0  0  0  0  0  0  0  0  0  0  1  
1  0  0  0  0  0  0  0  0  0  0  0  1  0  0  0  0  1  0  0  0  0  0  0  0  0  0  0  0  1  
6  1  1  1  1  1  4  0  0  9  1  1  8  1  1  1  1  8  1  1  9  0  0  3  1  1  1  1  1  5  
0  0  0  0  0  0  1  0  0  0  0  0  0  0  0  0  0  0  0  0  0  0  0  1  0  0  0  0  0  0  
0  0  0  0  0  0  1  0  0  0  0  0  0  0  0  0  0  0  0  0  0  0  0  1  0  0  0  0  0  0  
3  1  1  1  1  1  5  0  0  9  0  0  3  4  0  0  3  4  0  0  9  0  0  6  1  1  1  1  1  4  
1  0  0  0  0  0  0  0  0  1  0  0  1  1  0  0  1  1  0  0  1  0  0  0  0  0  0  0  0  1  
1  0  0  0  0  0  0  0  0  1  0  0  1  1  0  0  1  1  0  0  1  0  0  0  0  0  0  0  0  1  
6  1  1  1  1  1  9  0  0  1  0  0  6  5  0  0  6  5  0  0  1  0  0  9  1  1  1  1  1  5  
0  0  0  0  0  0  0  0  0  1  0  0  0  0  0  0  0  0  0  0  1  0  0  0  0  0  0  0  0  0  
0  0  0  0  0  0  0  0  0  1  0  0  0  0  0  0  0  0  0  0  1  0  0  0  0  0  0  0  0  0  
3  1  1  1  1  1  9  0  0  6  1  1  1  1  1  1  1  1  1  1  5  0  0  9  1  1  1  1  1  4  
1  0  0  0  0  0  0  0  0  0  0  0  0  0  0  0  0  0  0  0  0  0  0  0  0  0  0  0  0  1  
1  0  0  0  0  0  0  0  0  0  0  0  0  0  0  0  0  0  0  0  0  0  0  0  0  0  0  0  0  1  
1  0  0  9  0  0  9  0  0  9  1  1  1  9  0  0  9  1  1  1  9  0  0  9  0  0  9  0  0  1  
1  0  0  1  0  0  1  0  0  0  0  0  0  0  0  0  0  0  0  0  0  0  0  1  0  0  1  0  0  1  
1  0  0  1  0  0  1  0  0  0  0  0  0  0  0  0  0  0  0  0  0  0  0  1  0  0  1  0  0  1  
1  0  0  9  0  0  7  4  0  0  3  1  1  1  1  1  1  1  1  4  0  0  3  8  0  0  9  0  0  1  
1  0  0  0  0  0  1  1  0  0  1  0  0  0  0  0  0  0  0  1  0  0  1  1  0  0  0  0  0  1  
1  0  0  0  0  0  6  5  0  0  9  0  0  0  0  0  0  0  0  9  0  0  6  5  0  0  0  0  0  1  
1  0  0  9  0  0  0  0  0  0  0  0  0  3  2  2  4  0  0  0  0  0  0  0  0  0  9  0  0  1  
1  0  0  1  0  0  0  0  0  0  0  0  0  1  0  0  1  0  0  0  0  0  0  0  0  0  1  0  0  1  
1  0  0  6  1  1  1  1  9  0  0  3  1  5  0  0  6  1  4  0  0  9  1  1  1  1  5  0  0  1  
1  0  0  0  0  0  0  0  0  0  0  1  0  0  0  0  0  0  1  0  0  0  0  0  0  0  0  0  0  1  
1  0  0  0  0  0  0  0  0  0  0  1  0  0  0  0  0  0  1  0  0  0  0  0  0  0  0  0  0  1  
6  1  1  1  1  1  1  1  1  1  1  8  1  1  1  1  1  1  8  1  1  1  1  1  1  1  1  1  1  5  
